method: org.apache.fop.fonts.Typeface.getMaxAscent:1526684083
919896 -> 919897
919898 -> 919899
919897 -> 919900
919899 -> 919901
919900 -> 919902
919901 -> 919903
919902 -> 919904
919903 -> 919905
919904 -> 919906
919905 -> 919907
919906 -> 919908
919907 -> 919909
919906 -> 919910
