method: org.apache.fop.render.rtf.rtflib.rtfdoc.RtfSection.newBefore:742159106
2333548 -> 2333549
2333550 -> 2333551
2333552 -> 2333553
2333548 -> 2333554
2333548 -> 2333555
2333548 -> 2333556
2333549 -> 2333557
2333551 -> 2333558
2333553 -> 2333559
2333554 -> 2333560
2333555 -> 2333561
2333556 -> 2333562
2333557 -> 2333563
2333558 -> 2333564
2333559 -> 2333565
2333560 -> 2333566
2333561 -> 2333567
2333562 -> 2333568
2333563 -> 2333569
2333564 -> 2333570
2333565 -> 2333571
2333566 -> 2333572
2333567 -> 2333573
2333568 -> 2333574
2333569 -> 2333575
2333570 -> 2333576
2333571 -> 2333577
2333573 -> 2333578
2333574 -> 2333579
2333575 -> 2333580
2333576 -> 2333581
2333577 -> 2333582
2333583 -> 2333584
2333578 -> 2333585
2333579 -> 2333586
2333580 -> 2333587
2333581 -> 2333588
2333582 -> 2333589
2333584 -> 2333590
2333585 -> 2333591
2333586 -> 2333592
2333587 -> 2333593
2333588 -> 2333594
2333589 -> 2333595
2333590 -> 2333596
2333591 -> 2333597
2333592 -> 2333598
2333593 -> 2333599
2333594 -> 2333600
2333595 -> 2333601
2333596 -> 2333602
2333597 -> 2333603
2333598 -> 2333604
2333599 -> 2333605
2333600 -> 2333606
2333601 -> 2333607
2333602 -> 2333608
2333603 -> 2333609
2333604 -> 2333610
2333604 -> 2333611
