method: org.apache.fop.fo.flow.table.VariableColRowGroupBuilder.endTableRow:1925115537
244466 -> 244467
244468 -> 244469
244466 -> 244470
244466 -> 244471
244467 -> 244472
244469 -> 244473
244470 -> 244474
244471 -> 244475
244472 -> 244476
244473 -> 244477
244474 -> 244478
244475 -> 244479
244476 -> 244480
244477 -> 244481
244479 -> 244482
244480 -> 244483
244481 -> 244484
244485 -> 244486
244482 -> 244487
244483 -> 244488
244484 -> 244489
244486 -> 244490
244487 -> 244491
244488 -> 244492
244489 -> 244493
244490 -> 244494
244491 -> 244495
244488 -> 244496
