method: org.apache.fop.fo.FObjMixed.<init>:1805556236
252225 -> 252226
252227 -> 252228
252229 -> 252230
252226 -> 252231
252228 -> 252232
252230 -> 252233
252231 -> 252234
252232 -> 252235
252233 -> 252236
252234 -> 252237
252235 -> 252238
252236 -> 252239
252237 -> 252240
252238 -> 252241
252239 -> 252242
252240 -> 252243
252241 -> 252244
252242 -> 252245
252243 -> 252246
252244 -> 252247
252245 -> 252248
252243 -> 252249
