method: org.apache.fop.render.rtf.rtflib.rtfdoc.RtfTable.setBorderAttributes:1898222243
2339374 -> 2339375
2339376 -> 2339377
2339378 -> 2339379
2339375 -> 2339380
2339377 -> 2339381
2339379 -> 2339382
2339380 -> 2339383
2339381 -> 2339384
2339382 -> 2339385
2339383 -> 2339386
2339384 -> 2339387
2339385 -> 2339388
2339386 -> 2339389
2339387 -> 2339390
2339388 -> 2339391
2339386 -> 2339392
