method: org.apache.fop.area.Trait$InternalLink.setPVKey:540255907
112196 -> 112197
112198 -> 112199
112200 -> 112201
112197 -> 112202
112199 -> 112203
112201 -> 112204
112202 -> 112205
112203 -> 112206
112204 -> 112207
112205 -> 112208
112206 -> 112209
112207 -> 112210
112208 -> 112211
112209 -> 112212
112210 -> 112213
112208 -> 112214
