method: org.apache.fop.render.afp.modca.AFPDataStream.createText:1514918684
1811023 -> 1811024
1811025 -> 1811026
1811027 -> 1811028
1811029 -> 1811030
1811023 -> 1811031
1811024 -> 1811032
1811026 -> 1811033
1811028 -> 1811034
1811030 -> 1811035
1811031 -> 1811036
1811032 -> 1811037
1811033 -> 1811038
1811034 -> 1811039
1811035 -> 1811040
1811036 -> 1811041
1811037 -> 1811042
1811038 -> 1811043
1811039 -> 1811044
1811040 -> 1811045
1811041 -> 1811046
1811042 -> 1811047
1811043 -> 1811048
1811044 -> 1811049
1811045 -> 1811050
1811046 -> 1811051
1811047 -> 1811052
1811048 -> 1811053
1811049 -> 1811054
1811050 -> 1811055
1811051 -> 1811056
1811052 -> 1811057
1811053 -> 1811058
1811054 -> 1811059
1811055 -> 1811060
1811056 -> 1811061
1811057 -> 1811062
1811058 -> 1811063
1811059 -> 1811064
1811060 -> 1811065
1811061 -> 1811066
1811062 -> 1811067
1811063 -> 1811068
1811064 -> 1811069
1811065 -> 1811070
1811066 -> 1811071
1811067 -> 1811072
1811068 -> 1811073
1811069 -> 1811074
1811070 -> 1811075
1811071 -> 1811076
1811072 -> 1811077
1811073 -> 1811078
1811074 -> 1811079
1811075 -> 1811080
1811076 -> 1811081
1811077 -> 1811082
1811078 -> 1811083
1811079 -> 1811084
1811080 -> 1811085
1811081 -> 1811086
1811082 -> 1811087
1811083 -> 1811088
1811084 -> 1811089
1811085 -> 1811090
1811086 -> 1811091
1811087 -> 1811092
1811088 -> 1811093
1811089 -> 1811094
1811090 -> 1811095
1811091 -> 1811096
1811092 -> 1811097
1811093 -> 1811098
1811094 -> 1811099
1811095 -> 1811100
1811096 -> 1811101
1811097 -> 1811102
1811098 -> 1811103
1811099 -> 1811104
1811100 -> 1811105
1811101 -> 1811106
1811102 -> 1811107
1811103 -> 1811108
1811104 -> 1811109
1811105 -> 1811110
1811106 -> 1811111
1811102 -> 1811112
