method: org.apache.fop.pdf.PDFArray.<init>:1929795679
1545489 -> 1545490
1545491 -> 1545492
1545493 -> 1545494
1545495 -> 1545496
1545489 -> 1545497
1545489 -> 1545498
1545489 -> 1545499
1545490 -> 1545500
1545492 -> 1545501
1545494 -> 1545502
1545496 -> 1545503
1545497 -> 1545504
1545498 -> 1545505
1545499 -> 1545506
1545500 -> 1545507
1545501 -> 1545508
1545502 -> 1545509
1545503 -> 1545510
1545504 -> 1545511
1545505 -> 1545512
1545506 -> 1545513
1545507 -> 1545514
1545508 -> 1545515
1545509 -> 1545516
1545510 -> 1545517
1545511 -> 1545518
1545512 -> 1545519
1545513 -> 1545520
1545514 -> 1545521
1545515 -> 1545522
1545516 -> 1545523
1545517 -> 1545524
1545518 -> 1545525
1545519 -> 1545526
1545520 -> 1545527
1545521 -> 1545528
1545522 -> 1545529
1545523 -> 1545530
1545524 -> 1545531
1545526 -> 1545532
1545527 -> 1545533
1545528 -> 1545534
1545529 -> 1545535
1545530 -> 1545536
1545531 -> 1545537
1545538 -> 1545539
1545532 -> 1545540
1545533 -> 1545541
1545534 -> 1545542
1545535 -> 1545543
1545536 -> 1545544
1545537 -> 1545545
1545539 -> 1545546
1545540 -> 1545547
1545541 -> 1545548
1545542 -> 1545549
1545543 -> 1545550
1545544 -> 1545551
1545545 -> 1545552
1545546 -> 1545553
1545547 -> 1545554
1545548 -> 1545555
1545549 -> 1545556
1545550 -> 1545557
1545551 -> 1545558
1545552 -> 1545559
1545553 -> 1545560
1545554 -> 1545561
1545555 -> 1545562
1545556 -> 1545563
1545557 -> 1545564
1545558 -> 1545565
1545559 -> 1545566
1545560 -> 1545567
1545561 -> 1545568
1545562 -> 1545569
1545556 -> 1545570
1545557 -> 1545571
1545558 -> 1545572
1545559 -> 1545573
1545560 -> 1545574
1545561 -> 1545575
1545562 -> 1545576
1545570 -> 1545577
1545571 -> 1545578
1545572 -> 1545579
1545573 -> 1545580
1545574 -> 1545581
1545575 -> 1545582
1545576 -> 1545583
1545577 -> 1545584
1545578 -> 1545585
1545579 -> 1545586
1545580 -> 1545587
1545581 -> 1545588
1545582 -> 1545589
1545583 -> 1545590
1545584 -> 1545591
1545585 -> 1545592
1545586 -> 1545593
1545587 -> 1545594
1545588 -> 1545595
1545589 -> 1545596
1545590 -> 1545597
1545591 -> 1545598
1545592 -> 1545599
1545593 -> 1545600
1545594 -> 1545601
1545595 -> 1545602
1545596 -> 1545603
1545597 -> 1545604
1545598 -> 1545556
1545599 -> 1545557
1545600 -> 1545558
1545601 -> 1545559
1545602 -> 1545560
1545603 -> 1545561
1545604 -> 1545562
1545563 -> 1545605
1545564 -> 1545606
1545565 -> 1545607
1545566 -> 1545608
1545567 -> 1545609
1545568 -> 1545610
1545569 -> 1545611
1545563 -> 1545612
