method: org.apache.fop.pdf.PDFDocument.getEncryption:764577629
1561181 -> 1561182
1561183 -> 1561184
1561181 -> 1561185
1561182 -> 1561186
1561184 -> 1561187
1561185 -> 1561188
1561186 -> 1561189
1561187 -> 1561190
1561188 -> 1561191
1561189 -> 1561192
1561190 -> 1561193
1561191 -> 1561194
1561191 -> 1561195
