method: org.apache.fop.render.pcl.PCLRenderer.drawBorders:1968024004
2000138 -> 2000139
2000140 -> 2000141
2000142 -> 2000143
2000144 -> 2000145
2000146 -> 2000147
2000148 -> 2000149
2000150 -> 2000151
2000139 -> 2000152
2000141 -> 2000153
2000143 -> 2000154
2000145 -> 2000155
2000147 -> 2000156
2000149 -> 2000157
2000151 -> 2000158
2000152 -> 2000159
2000153 -> 2000160
2000154 -> 2000161
2000155 -> 2000162
2000156 -> 2000163
2000157 -> 2000164
2000158 -> 2000165
2000159 -> 2000166
2000160 -> 2000167
2000161 -> 2000168
2000162 -> 2000169
2000163 -> 2000170
2000164 -> 2000171
2000165 -> 2000172
2000166 -> 2000173
2000167 -> 2000174
2000168 -> 2000175
2000169 -> 2000176
2000170 -> 2000177
2000171 -> 2000178
2000172 -> 2000179
2000173 -> 2000180
2000174 -> 2000181
2000175 -> 2000182
2000176 -> 2000183
2000177 -> 2000184
2000178 -> 2000185
2000179 -> 2000186
2000180 -> 2000187
2000181 -> 2000188
2000182 -> 2000189
2000183 -> 2000190
2000184 -> 2000191
2000185 -> 2000192
2000186 -> 2000193
2000187 -> 2000194
2000188 -> 2000195
2000189 -> 2000196
2000190 -> 2000197
2000191 -> 2000198
2000192 -> 2000199
2000193 -> 2000200
2000187 -> 2000201
2000188 -> 2000202
2000189 -> 2000203
2000190 -> 2000204
2000191 -> 2000205
2000192 -> 2000206
2000193 -> 2000207
2000201 -> 2000194
2000202 -> 2000195
2000203 -> 2000196
2000204 -> 2000197
2000205 -> 2000198
2000206 -> 2000199
2000207 -> 2000200
2000201 -> 2000208
2000202 -> 2000209
2000203 -> 2000210
2000204 -> 2000211
2000205 -> 2000212
2000206 -> 2000213
2000207 -> 2000214
2000208 -> 2000194
2000209 -> 2000195
2000210 -> 2000196
2000211 -> 2000197
2000212 -> 2000198
2000213 -> 2000199
2000214 -> 2000200
2000208 -> 2000215
2000209 -> 2000216
2000210 -> 2000217
2000211 -> 2000218
2000212 -> 2000219
2000213 -> 2000220
2000214 -> 2000221
2000215 -> 2000194
2000216 -> 2000195
2000217 -> 2000196
2000218 -> 2000197
2000219 -> 2000198
2000220 -> 2000199
2000221 -> 2000200
2000215 -> 2000222
2000216 -> 2000223
2000217 -> 2000224
2000218 -> 2000225
2000219 -> 2000226
2000220 -> 2000227
2000221 -> 2000228
2000222 -> 2000229
2000223 -> 2000230
2000224 -> 2000231
2000225 -> 2000232
2000226 -> 2000233
2000227 -> 2000234
2000228 -> 2000235
2000222 -> 2000236
2000194 -> 2000237
2000195 -> 2000238
2000196 -> 2000239
2000197 -> 2000240
2000198 -> 2000241
2000199 -> 2000242
2000200 -> 2000243
2000237 -> 2000244
2000238 -> 2000245
2000239 -> 2000246
2000240 -> 2000247
2000241 -> 2000248
2000242 -> 2000249
2000243 -> 2000250
2000237 -> 2000251
2000238 -> 2000252
2000239 -> 2000253
2000240 -> 2000254
2000241 -> 2000255
2000242 -> 2000256
2000243 -> 2000257
2000251 -> 2000258
2000252 -> 2000259
2000253 -> 2000260
2000254 -> 2000261
2000255 -> 2000262
2000256 -> 2000263
2000257 -> 2000264
2000258 -> 2000265
2000259 -> 2000266
2000260 -> 2000267
2000261 -> 2000268
2000262 -> 2000269
2000263 -> 2000270
2000264 -> 2000271
2000244 -> 2000265
2000245 -> 2000266
2000246 -> 2000267
2000247 -> 2000268
2000248 -> 2000269
2000249 -> 2000270
2000250 -> 2000271
2000265 -> 2000229
2000266 -> 2000230
2000267 -> 2000231
2000268 -> 2000232
2000269 -> 2000233
2000270 -> 2000234
2000271 -> 2000235
2000265 -> 2000236
