method: org.apache.fop.fo.FOElementMapping$InlineContainerMaker.make:1679772021
254539 -> 254540
254541 -> 254542
254543 -> 254544
254539 -> 254545
254540 -> 254546
254542 -> 254547
254544 -> 254548
254545 -> 254549
254546 -> 254550
254547 -> 254551
254548 -> 254552
254549 -> 254553
254550 -> 254554
254551 -> 254555
254552 -> 254556
254554 -> 254557
254555 -> 254558
254556 -> 254559
254560 -> 254561
254557 -> 254562
254558 -> 254563
254559 -> 254564
254561 -> 254565
254561 -> 254566
