method: org.apache.fop.render.ps.extensions.PSExtensionHandler.getObject:798826477
2122134 -> 2122135
2122136 -> 2122137
2122134 -> 2122138
2122135 -> 2122139
2122137 -> 2122140
2122138 -> 2122141
2122139 -> 2122142
2122140 -> 2122143
2122141 -> 2122144
2122142 -> 2122145
2122143 -> 2122146
2122144 -> 2122147
2122144 -> 2122148
