method: org.apache.fop.render.rtf.rtflib.rtfdoc.RtfSection.newJforCmd:544493745
2333676 -> 2333677
2333678 -> 2333679
2333680 -> 2333681
2333676 -> 2333682
2333676 -> 2333683
2333676 -> 2333684
2333677 -> 2333685
2333679 -> 2333686
2333681 -> 2333687
2333682 -> 2333688
2333683 -> 2333689
2333684 -> 2333690
2333685 -> 2333691
2333686 -> 2333692
2333687 -> 2333693
2333688 -> 2333694
2333689 -> 2333695
2333690 -> 2333696
2333691 -> 2333697
2333692 -> 2333698
2333693 -> 2333699
2333695 -> 2333700
2333696 -> 2333701
2333697 -> 2333702
2333698 -> 2333703
2333699 -> 2333704
2333705 -> 2333706
2333700 -> 2333707
2333701 -> 2333708
2333702 -> 2333709
2333703 -> 2333710
2333704 -> 2333711
2333706 -> 2333712
2333707 -> 2333713
2333708 -> 2333714
2333709 -> 2333715
2333710 -> 2333716
2333711 -> 2333717
2333712 -> 2333718
2333713 -> 2333719
2333714 -> 2333720
2333715 -> 2333721
2333716 -> 2333722
2333717 -> 2333723
2333718 -> 2333724
2333719 -> 2333725
2333720 -> 2333726
2333721 -> 2333727
2333722 -> 2333728
2333723 -> 2333729
2333724 -> 2333730
2333725 -> 2333731
2333726 -> 2333732
2333726 -> 2333733
