method: org.apache.fop.render.bitmap.PNGRenderer_onthefly.getMimeType:438588762
1888542 -> 1888543
1888544 -> 1888545
1888543 -> 1888546
1888545 -> 1888547
1888546 -> 1888548
1888547 -> 1888549
1888546 -> 1888550
