method: org.apache.fop.fo.FOElementMapping$RepeatablePageMasterReferenceMaker.<init>:1553001578
255581 -> 255582
255583 -> 255584
255582 -> 255585
255584 -> 255586
255585 -> 255587
255586 -> 255588
255587 -> 255589
255588 -> 255590
255587 -> 255591
