method: org.apache.fop.render.rtf.rtflib.exceptions.RtfStructureException.<init>:278750909
2299212 -> 2299213
2299214 -> 2299215
2299216 -> 2299217
2299213 -> 2299218
2299215 -> 2299219
2299217 -> 2299220
2299218 -> 2299221
2299219 -> 2299222
2299220 -> 2299223
2299221 -> 2299224
2299222 -> 2299225
2299223 -> 2299226
2299224 -> 2299227
2299225 -> 2299228
2299226 -> 2299229
2299224 -> 2299230
