method: org.apache.fop.fo.pagination.SimplePageMaster.endOfNode:122549765
359993 -> 359994
359995 -> 359996
359994 -> 359997
359996 -> 359998
359997 -> 359999
359998 -> 360000
359999 -> 360001
360000 -> 360002
359999 -> 360003
360000 -> 360004
360003 -> 360001
360004 -> 360002
360001 -> 360005
360002 -> 360006
360001 -> 360007
