method: org.apache.fop.render.afp.modca.IMImageObject.writeStart:1320987041
1821071 -> 1821072
1821073 -> 1821074
1821075 -> 1821076
1821071 -> 1821077
1821071 -> 1821078
1821071 -> 1821079
1821072 -> 1821080
1821074 -> 1821081
1821076 -> 1821082
1821077 -> 1821083
1821078 -> 1821084
1821079 -> 1821085
1821080 -> 1821086
1821081 -> 1821087
1821082 -> 1821088
1821083 -> 1821089
1821084 -> 1821090
1821085 -> 1821091
1821086 -> 1821092
1821087 -> 1821093
1821088 -> 1821094
1821090 -> 1821095
1821091 -> 1821096
1821092 -> 1821097
1821093 -> 1821098
1821094 -> 1821099
1821100 -> 1821101
1821095 -> 1821102
1821096 -> 1821103
1821097 -> 1821104
1821098 -> 1821105
1821099 -> 1821106
1821101 -> 1821107
1821102 -> 1821108
1821103 -> 1821109
1821104 -> 1821110
1821105 -> 1821111
1821106 -> 1821112
1821107 -> 1821113
1821108 -> 1821114
1821109 -> 1821115
1821110 -> 1821116
1821111 -> 1821117
1821112 -> 1821118
1821113 -> 1821119
1821114 -> 1821120
1821115 -> 1821121
1821116 -> 1821122
1821117 -> 1821123
1821118 -> 1821124
1821119 -> 1821125
1821120 -> 1821126
1821121 -> 1821127
1821122 -> 1821128
1821123 -> 1821129
1821124 -> 1821130
1821125 -> 1821131
1821126 -> 1821132
1821127 -> 1821133
1821128 -> 1821134
1821129 -> 1821135
1821130 -> 1821136
1821131 -> 1821137
1821132 -> 1821138
1821133 -> 1821139
1821134 -> 1821140
1821135 -> 1821141
1821136 -> 1821142
1821137 -> 1821143
1821138 -> 1821144
1821139 -> 1821145
1821140 -> 1821146
1821141 -> 1821147
1821142 -> 1821148
1821143 -> 1821149
1821144 -> 1821150
1821145 -> 1821151
1821146 -> 1821152
1821147 -> 1821153
1821148 -> 1821154
1821149 -> 1821155
1821150 -> 1821156
1821151 -> 1821157
1821152 -> 1821158
1821153 -> 1821159
1821154 -> 1821160
1821155 -> 1821161
1821156 -> 1821162
1821157 -> 1821163
1821158 -> 1821164
1821159 -> 1821165
1821160 -> 1821166
1821161 -> 1821167
1821162 -> 1821168
1821163 -> 1821169
1821164 -> 1821170
1821165 -> 1821171
1821166 -> 1821172
1821167 -> 1821173
1821168 -> 1821174
1821169 -> 1821175
1821164 -> 1821176
1821165 -> 1821177
1821166 -> 1821178
1821167 -> 1821179
1821168 -> 1821180
1821169 -> 1821181
1821176 -> 1821182
1821177 -> 1821183
1821178 -> 1821184
1821179 -> 1821185
1821180 -> 1821186
1821181 -> 1821187
1821182 -> 1821188
1821183 -> 1821189
1821184 -> 1821190
1821185 -> 1821191
1821186 -> 1821192
1821187 -> 1821193
1821188 -> 1821194
1821189 -> 1821195
1821190 -> 1821196
1821191 -> 1821197
1821192 -> 1821198
1821193 -> 1821199
1821194 -> 1821200
1821195 -> 1821201
1821196 -> 1821202
1821197 -> 1821203
1821198 -> 1821204
1821199 -> 1821205
1821200 -> 1821206
1821201 -> 1821207
1821202 -> 1821208
1821203 -> 1821209
1821204 -> 1821210
1821205 -> 1821211
1821206 -> 1821152
1821207 -> 1821153
1821208 -> 1821154
1821209 -> 1821155
1821210 -> 1821156
1821211 -> 1821157
1821170 -> 1821212
1821171 -> 1821213
1821172 -> 1821214
1821173 -> 1821215
1821174 -> 1821216
1821175 -> 1821217
1821212 -> 1821218
1821213 -> 1821219
1821214 -> 1821220
1821215 -> 1821221
1821216 -> 1821222
1821217 -> 1821223
1821212 -> 1821224
