method: org.apache.fop.area.inline.Viewport.setContentPosition:1873349776
87765 -> 87766
87767 -> 87768
87769 -> 87770
87766 -> 87771
87768 -> 87772
87770 -> 87773
87771 -> 87774
87772 -> 87775
87773 -> 87776
87774 -> 87777
87775 -> 87778
87776 -> 87779
87777 -> 87780
87778 -> 87781
87779 -> 87782
87777 -> 87783
