method: org.apache.fop.layoutmgr.AbstractLayoutManager.setFinished:919463779
997933 -> 997934
997935 -> 997936
997934 -> 997937
997936 -> 997938
997937 -> 997939
997938 -> 997940
997939 -> 997941
997940 -> 997942
997941 -> 997943
997942 -> 997944
997941 -> 997945
