method: org.apache.fop.render.rtf.rtflib.rtfdoc.RtfSection.getTextrun:2102422614
2333919 -> 2333920
2333921 -> 2333922
2333919 -> 2333923
2333919 -> 2333924
2333920 -> 2333925
2333922 -> 2333926
2333923 -> 2333927
2333924 -> 2333928
2333925 -> 2333929
2333926 -> 2333930
2333927 -> 2333931
2333928 -> 2333932
2333929 -> 2333933
2333930 -> 2333934
2333931 -> 2333935
2333933 -> 2333936
2333934 -> 2333937
2333935 -> 2333938
2333939 -> 2333940
2333936 -> 2333941
2333937 -> 2333942
2333938 -> 2333943
2333940 -> 2333944
2333940 -> 2333945
