method: org.apache.fop.layoutmgr.AbstractBaseLayoutManager.getContentAreaBPD:285471476
973330 -> 973331
973332 -> 973333
973330 -> 973334
973331 -> 973335
973333 -> 973336
973334 -> 973337
973335 -> 973338
973336 -> 973339
973337 -> 973340
973338 -> 973341
973339 -> 973342
973340 -> 973343
973341 -> 973344
973342 -> 973345
973343 -> 973346
973341 -> 973347
