method: org.apache.fop.render.bitmap.PNGRendererMaker.needsOutputStream:80364665
1888495 -> 1888496
1888497 -> 1888498
1888496 -> 1888499
1888498 -> 1888500
1888499 -> 1888501
1888500 -> 1888502
1888499 -> 1888503
