method: org.apache.fop.render.java2d.Java2DSVGHandler.getNamespace:1420801855
1933303 -> 1933304
1933305 -> 1933306
1933304 -> 1933307
1933306 -> 1933308
1933307 -> 1933309
1933308 -> 1933310
1933307 -> 1933311
