method: org.apache.fop.pdf.PDFColor.convertRGBtoCMYK:501834220
1555774 -> 1555775
1555776 -> 1555777
1555775 -> 1555778
1555777 -> 1555779
1555778 -> 1555780
1555779 -> 1555781
1555780 -> 1555782
1555781 -> 1555783
1555782 -> 1555784
1555783 -> 1555785
1555784 -> 1555786
1555785 -> 1555787
1555786 -> 1555788
1555787 -> 1555789
1555788 -> 1555790
1555789 -> 1555791
1555790 -> 1555792
1555791 -> 1555793
1555792 -> 1555794
1555793 -> 1555795
1555794 -> 1555796
1555795 -> 1555797
1555796 -> 1555798
1555797 -> 1555799
1555798 -> 1555800
1555799 -> 1555801
1555798 -> 1555802
