method: org.apache.fop.render.ps.extensions.AbstractPSExtensionObject.endOfNode:2137375111
2119091 -> 2119092
2119093 -> 2119094
2119091 -> 2119095
2119091 -> 2119096
2119092 -> 2119097
2119094 -> 2119098
2119095 -> 2119099
2119096 -> 2119100
2119097 -> 2119101
2119098 -> 2119102
2119099 -> 2119103
2119100 -> 2119104
2119101 -> 2119105
2119102 -> 2119106
2119103 -> 2119107
2119104 -> 2119108
2119105 -> 2119109
2119106 -> 2119110
2119108 -> 2119111
2119109 -> 2119112
2119110 -> 2119113
2119114 -> 2119115
2119111 -> 2119116
2119112 -> 2119117
2119113 -> 2119118
2119115 -> 2119119
2119116 -> 2119120
2119112 -> 2119121
2119113 -> 2119122
2119115 -> 2119123
2119116 -> 2119124
2119121 -> 2119125
2119122 -> 2119126
2119123 -> 2119127
2119124 -> 2119128
2119125 -> 2119129
2119126 -> 2119130
2119127 -> 2119131
2119128 -> 2119132
2119129 -> 2119133
2119130 -> 2119134
2119131 -> 2119135
2119132 -> 2119136
2119129 -> 2119117
2119130 -> 2119118
2119131 -> 2119119
2119132 -> 2119120
2119117 -> 2119133
2119118 -> 2119134
2119119 -> 2119135
2119120 -> 2119136
2119133 -> 2119137
2119134 -> 2119138
2119135 -> 2119139
2119136 -> 2119140
2119133 -> 2119141
