method: org.apache.fop.fo.properties.EnumProperty.<clinit>:1539190537
383930 -> 383931
383930 -> 383932
383931 -> 383933
383933 -> 383934
383935 -> 383936
383934 -> 383937
383936 -> 383938
383937 -> 383939
383938 -> 383940
383937 -> 383941
