method: org.apache.fop.apps.FopFactory.newFOUserAgent:1172147837
2213 -> 2214
2215 -> 2216
2213 -> 2217
2213 -> 2218
2214 -> 2219
2216 -> 2220
2217 -> 2221
2218 -> 2222
2219 -> 2223
2220 -> 2224
2222 -> 2225
2223 -> 2226
2224 -> 2227
2228 -> 2229
2225 -> 2230
2226 -> 2231
2227 -> 2232
2229 -> 2233
2229 -> 2234
2231 -> 2235
2232 -> 2236
2234 -> 2237
2233 -> 2238
2233 -> 2239
