method: org.apache.fop.render.RendererContext.setProperty:1100178724
2225323 -> 2225324
2225325 -> 2225326
2225327 -> 2225328
2225329 -> 2225330
2225323 -> 2225331
2225324 -> 2225332
2225326 -> 2225333
2225328 -> 2225334
2225330 -> 2225335
2225331 -> 2225336
2225332 -> 2225337
2225333 -> 2225338
2225334 -> 2225339
2225335 -> 2225340
2225336 -> 2225341
2225337 -> 2225342
2225338 -> 2225343
2225339 -> 2225344
2225340 -> 2225345
2225341 -> 2225346
2225342 -> 2225347
2225343 -> 2225348
2225344 -> 2225349
2225345 -> 2225350
2225346 -> 2225351
2225347 -> 2225352
2225348 -> 2225353
2225349 -> 2225354
2225350 -> 2225355
2225351 -> 2225356
2225352 -> 2225357
2225353 -> 2225358
2225354 -> 2225359
2225355 -> 2225360
2225356 -> 2225361
2225352 -> 2225362
