method: org.apache.fop.render.afp.fonts.CharacterSet.getEncoding:641968285
1800013 -> 1800014
1800015 -> 1800016
1800013 -> 1800017
1800014 -> 1800018
1800016 -> 1800019
1800017 -> 1800020
1800018 -> 1800021
1800019 -> 1800022
1800020 -> 1800023
1800021 -> 1800024
1800022 -> 1800025
1800023 -> 1800026
1800023 -> 1800027
