method: org.apache.fop.render.java2d.Java2DRenderer.breakOutOfStateStack:456045279
1911513 -> 1911514
1911515 -> 1911516
1911513 -> 1911517
1911513 -> 1911518
1911513 -> 1911519
1911513 -> 1911520
1911513 -> 1911521
1911513 -> 1911522
1911513 -> 1911523
1911513 -> 1911524
1911514 -> 1911525
1911516 -> 1911526
1911517 -> 1911527
1911518 -> 1911528
1911519 -> 1911529
1911520 -> 1911530
1911521 -> 1911531
1911522 -> 1911532
1911523 -> 1911533
1911524 -> 1911534
1911525 -> 1911535
1911526 -> 1911536
1911527 -> 1911537
1911528 -> 1911538
1911529 -> 1911539
1911530 -> 1911540
1911531 -> 1911541
1911532 -> 1911542
1911533 -> 1911543
1911534 -> 1911544
1911535 -> 1911545
1911536 -> 1911546
1911537 -> 1911547
1911538 -> 1911548
1911539 -> 1911549
1911540 -> 1911550
1911541 -> 1911551
1911542 -> 1911552
1911543 -> 1911553
1911544 -> 1911554
1911545 -> 1911555
1911546 -> 1911556
1911547 -> 1911557
1911548 -> 1911558
1911550 -> 1911559
1911551 -> 1911560
1911552 -> 1911561
1911553 -> 1911562
1911554 -> 1911563
1911555 -> 1911564
1911556 -> 1911565
1911557 -> 1911566
1911558 -> 1911567
1911568 -> 1911569
1911559 -> 1911570
1911560 -> 1911571
1911561 -> 1911572
1911562 -> 1911573
1911563 -> 1911574
1911564 -> 1911575
1911565 -> 1911576
1911566 -> 1911577
1911569 -> 1911578
1911569 -> 1911579
1911570 -> 1911580
1911571 -> 1911581
1911572 -> 1911582
1911573 -> 1911583
1911574 -> 1911584
1911575 -> 1911585
1911576 -> 1911586
1911577 -> 1911587
1911578 -> 1911588
1911579 -> 1911589
1911580 -> 1911590
1911581 -> 1911591
1911582 -> 1911592
1911583 -> 1911593
1911584 -> 1911594
1911585 -> 1911595
1911586 -> 1911596
1911587 -> 1911597
1911588 -> 1911598
1911589 -> 1911599
1911590 -> 1911600
1911591 -> 1911601
1911592 -> 1911602
1911593 -> 1911603
1911594 -> 1911604
1911595 -> 1911605
1911596 -> 1911606
1911597 -> 1911607
1911598 -> 1911608
1911599 -> 1911609
1911600 -> 1911610
1911601 -> 1911611
1911602 -> 1911612
1911603 -> 1911613
1911604 -> 1911614
1911605 -> 1911615
1911606 -> 1911616
1911607 -> 1911617
1911608 -> 1911618
1911609 -> 1911619
1911610 -> 1911620
1911611 -> 1911621
1911612 -> 1911622
1911613 -> 1911623
1911614 -> 1911624
1911605 -> 1911625
1911606 -> 1911626
1911607 -> 1911627
1911608 -> 1911628
1911609 -> 1911629
1911610 -> 1911630
1911611 -> 1911631
1911612 -> 1911632
1911613 -> 1911633
1911614 -> 1911634
1911625 -> 1911635
1911626 -> 1911636
1911627 -> 1911637
1911628 -> 1911638
1911629 -> 1911639
1911630 -> 1911640
1911631 -> 1911641
1911632 -> 1911642
1911633 -> 1911643
1911634 -> 1911644
1911635 -> 1911645
1911636 -> 1911646
1911637 -> 1911647
1911638 -> 1911648
1911639 -> 1911649
1911640 -> 1911650
1911641 -> 1911651
1911642 -> 1911652
1911643 -> 1911653
1911644 -> 1911654
1911645 -> 1911655
1911646 -> 1911656
1911647 -> 1911657
1911648 -> 1911658
1911649 -> 1911659
1911650 -> 1911660
1911651 -> 1911661
1911652 -> 1911662
1911653 -> 1911663
1911654 -> 1911664
1911655 -> 1911665
1911656 -> 1911666
1911657 -> 1911667
1911658 -> 1911668
1911659 -> 1911669
1911660 -> 1911670
1911661 -> 1911671
1911662 -> 1911672
1911664 -> 1911673
1911665 -> 1911674
1911666 -> 1911675
1911667 -> 1911676
1911668 -> 1911677
1911669 -> 1911678
1911670 -> 1911679
1911671 -> 1911680
1911672 -> 1911681
1911682 -> 1911683
1911673 -> 1911684
1911674 -> 1911685
1911675 -> 1911686
1911676 -> 1911687
1911677 -> 1911688
1911678 -> 1911689
1911679 -> 1911690
1911680 -> 1911691
1911681 -> 1911692
1911683 -> 1911693
1911683 -> 1911694
1911685 -> 1911695
1911686 -> 1911696
1911687 -> 1911697
1911688 -> 1911698
1911689 -> 1911699
1911690 -> 1911700
1911691 -> 1911701
1911692 -> 1911702
1911694 -> 1911703
1911693 -> 1911704
1911695 -> 1911575
1911696 -> 1911576
1911697 -> 1911577
1911698 -> 1911578
1911699 -> 1911579
1911700 -> 1911580
1911701 -> 1911581
1911702 -> 1911582
1911703 -> 1911583
1911704 -> 1911584
1911615 -> 1911705
1911616 -> 1911706
1911617 -> 1911707
1911618 -> 1911708
1911619 -> 1911709
1911620 -> 1911710
1911621 -> 1911711
1911622 -> 1911712
1911623 -> 1911713
1911624 -> 1911714
1911618 -> 1911715
