method: org.apache.fop.layoutmgr.inline.ImageLayout.isClipped:2003363738
1171920 -> 1171921
1171922 -> 1171923
1171921 -> 1171924
1171923 -> 1171925
1171924 -> 1171926
1171925 -> 1171927
1171926 -> 1171928
1171927 -> 1171929
1171926 -> 1171930
