method: org.apache.fop.render.RendererContext$RendererContextWrapper.<init>:1010779004
2224920 -> 2224921
2224922 -> 2224923
2224924 -> 2224925
2224921 -> 2224926
2224923 -> 2224927
2224925 -> 2224928
2224926 -> 2224929
2224927 -> 2224930
2224928 -> 2224931
2224929 -> 2224932
2224930 -> 2224933
2224931 -> 2224934
2224932 -> 2224935
2224933 -> 2224936
2224934 -> 2224937
2224935 -> 2224938
2224936 -> 2224939
2224937 -> 2224940
2224935 -> 2224941
