method: org.apache.fop.util.DelegatingContentHandler.setDelegateContentHandler:459447016
2622951 -> 2622952
2622953 -> 2622954
2622955 -> 2622956
2622952 -> 2622957
2622954 -> 2622958
2622956 -> 2622959
2622957 -> 2622960
2622958 -> 2622961
2622959 -> 2622962
2622960 -> 2622963
2622961 -> 2622964
2622962 -> 2622965
2622963 -> 2622966
2622964 -> 2622967
2622965 -> 2622968
2622963 -> 2622969
