method: org.apache.fop.layoutmgr.AbstractLayoutManager.hasNextChildLM:1970679727
997901 -> 997902
997903 -> 997904
997901 -> 997905
997902 -> 997906
997904 -> 997907
997905 -> 997908
997906 -> 997909
997907 -> 997910
997908 -> 997911
997909 -> 997912
997910 -> 997913
997911 -> 997914
997912 -> 997915
997913 -> 997916
997914 -> 997917
997915 -> 997918
997916 -> 997919
997917 -> 997920
997915 -> 997921
