method: org.apache.fop.layoutmgr.inline.BasicScaledBaselineTable.class$:1538422567
1151876 -> 1151877
1151878 -> 1151879
1151876 -> 1151880
1151876 -> 1151881
1151876 -> 1151882
1151876 -> 1151883
1151876 -> 1151884
1151877 -> 1151885
1151879 -> 1151886
1151880 -> 1151887
1151881 -> 1151888
1151882 -> 1151889
1151883 -> 1151890
1151884 -> 1151891
1151885 -> 1151892
1151886 -> 1151893
1151887 -> 1151894
1151889 -> 1151895
1151890 -> 1151896
1151891 -> 1151897
1151892 -> 1151898
1151893 -> 1151899
1151894 -> 1151900
1151901 -> 1151902
1151895 -> 1151903
1151896 -> 1151904
1151897 -> 1151905
1151898 -> 1151906
1151899 -> 1151907
1151900 -> 1151908
1151902 -> 1151909
1151903 -> 1151910
1151904 -> 1151911
1151905 -> 1151912
1151902 -> 1151913
1151914 -> 1151915
1151916 -> 1151917
1151918 -> 1151919
1151920 -> 1151921
1151920 -> 1151922
1151923 -> 1151924
1151925 -> 1151926
1151915 -> 1151927
1151917 -> 1151928
1151921 -> 1151929
1151919 -> 1151930
1151922 -> 1151931
1151926 -> 1151932
1151927 -> 1151933
1151928 -> 1151934
1151929 -> 1151935
1151930 -> 1151936
1151931 -> 1151937
1151938 -> 1151939
1151932 -> 1151940
1151933 -> 1151941
1151934 -> 1151942
1151935 -> 1151943
1151936 -> 1151944
1151937 -> 1151945
1151939 -> 1151946
1151941 -> 1151947
1151942 -> 1151948
1151943 -> 1151949
1151944 -> 1151950
1151945 -> 1151951
1151946 -> 1151952
1151953 -> 1151954
