method: org.apache.fop.fo.OneCharIterator.hasNext:342306233
335528 -> 335529
335530 -> 335531
335529 -> 335532
335531 -> 335533
335532 -> 335534
335533 -> 335535
335534 -> 335536
335535 -> 335537
335534 -> 335538
