method: org.apache.fop.layoutmgr.AbstractPageSequenceLayoutManager.initialize:1528520684
1000045 -> 1000046
1000047 -> 1000048
1000045 -> 1000049
1000046 -> 1000050
1000048 -> 1000051
1000049 -> 1000052
1000050 -> 1000053
1000051 -> 1000054
1000052 -> 1000055
1000053 -> 1000056
1000054 -> 1000057
1000055 -> 1000058
1000056 -> 1000059
1000057 -> 1000060
1000058 -> 1000061
1000059 -> 1000062
1000060 -> 1000063
1000061 -> 1000064
1000062 -> 1000065
1000063 -> 1000066
1000064 -> 1000067
1000065 -> 1000068
1000066 -> 1000069
1000067 -> 1000070
1000068 -> 1000071
1000069 -> 1000072
1000070 -> 1000073
1000071 -> 1000074
1000072 -> 1000075
1000073 -> 1000076
1000071 -> 1000077
