method: org.apache.fop.render.print.PrintRenderer.getPrinterJob:50110101
2100032 -> 2100033
2100034 -> 2100035
2100032 -> 2100036
2100033 -> 2100037
2100035 -> 2100038
2100036 -> 2100039
2100037 -> 2100040
2100038 -> 2100041
2100039 -> 2100042
2100040 -> 2100043
2100041 -> 2100044
2100042 -> 2100045
2100042 -> 2100046
