method: org.apache.fop.render.bitmap.PNGRenderer_onthefly.<init>:1267919249
1888531 -> 1888532
1888533 -> 1888534
1888532 -> 1888535
1888534 -> 1888536
1888535 -> 1888537
1888536 -> 1888538
1888537 -> 1888539
1888538 -> 1888540
1888537 -> 1888541
