method: org.apache.fop.util.DelegatingContentHandler.getDelegateContentHandler:771905049
2622936 -> 2622937
2622938 -> 2622939
2622936 -> 2622940
2622937 -> 2622941
2622939 -> 2622942
2622940 -> 2622943
2622941 -> 2622944
2622942 -> 2622945
2622943 -> 2622946
2622944 -> 2622947
2622945 -> 2622948
2622946 -> 2622949
2622946 -> 2622950
