method: org.apache.fop.pdf.PDFDeviceColorSpace.calculateNumComponents:275268506
1556526 -> 1556527
1556528 -> 1556529
1556527 -> 1556530
1556529 -> 1556531
1556530 -> 1556532
1556531 -> 1556533
1556532 -> 1556534
1556533 -> 1556535
1556532 -> 1556536
1556533 -> 1556537
1556536 -> 1556538
1556537 -> 1556539
1556536 -> 1556540
1556534 -> 1556541
1556535 -> 1556542
1556541 -> 1556543
1556542 -> 1556544
1556541 -> 1556545
1556542 -> 1556546
1556545 -> 1556538
1556546 -> 1556539
1556545 -> 1556540
1556543 -> 1556547
1556544 -> 1556548
1556547 -> 1556549
1556548 -> 1556550
1556547 -> 1556551
1556548 -> 1556552
1556551 -> 1556538
1556552 -> 1556539
1556551 -> 1556540
1556549 -> 1556538
1556550 -> 1556539
1556549 -> 1556540
