method: org.apache.fop.render.afp.AFPRendererConfigurator.<init>:1124360971
1761162 -> 1761163
1761164 -> 1761165
1761166 -> 1761167
1761163 -> 1761168
1761165 -> 1761169
1761167 -> 1761170
1761168 -> 1761171
1761169 -> 1761172
1761170 -> 1761173
1761171 -> 1761174
1761172 -> 1761175
1761173 -> 1761176
1761174 -> 1761177
1761175 -> 1761178
1761176 -> 1761179
1761174 -> 1761180
