method: org.apache.fop.layoutmgr.inline.ImageLayout.getViewportSize:1413231528
1171890 -> 1171891
1171892 -> 1171893
1171890 -> 1171894
1171891 -> 1171895
1171893 -> 1171896
1171894 -> 1171897
1171895 -> 1171898
1171896 -> 1171899
1171897 -> 1171900
1171898 -> 1171901
1171899 -> 1171902
1171900 -> 1171903
1171900 -> 1171904
