method: org.apache.fop.util.DefaultErrorListener.fatalError:67053677
2622913 -> 2622914
2622915 -> 2622916
2622917 -> 2622918
2622914 -> 2622919
2622916 -> 2622920
2622918 -> 2622921
2622919 -> 2622922
2622920 -> 2622923
2622921 -> 2622924
